111111111111111
10CCC0000000011
1P00000000000E1
100000000000001
100000000000001
100000000000001
111111111110W01
111111111111111
