111111111111111111111111111111
10000C000000000000000000000001
10000C000000000000000000000001
10000C0000000000000000E0000001
1P000C000000000000000000000001
10000C0000000000000000000W0001
111111111111111111111111111111

