111111111111111111111111111111
100000000000000000000000000101
1010101110101110101110101001C1
1010101110101110101010101001C1
1010101110100E10101110101001C1
1011101000001110101010101001C1
1010101011111110101010101000C1
1010100010101010101010000000C1
1C1110101011111010111011100001
101010101000001C10100010100001
101010101010111010111010100001
101010100010101011101010100001
1P10001111100000101000101W0001
111111111111111111111111111111
